XXXXXXXXXXXXXXXXXXXXXXXXXXXXXXXX
XX                            XX
XX                            XX
XX              E             XX
XX           XXXXXX           XX
XX                            XX
XX                            XX
XX                            XX
XX                            XX
XX        XXXXX  XXXXX        XX
XX                            XX
XX                            XX
XX                            XX
XX                            XX
XX     XXXXXXXXXXXXXXXXXX     XX
XX                            XX
XX                            XX
XX                            XX
XX                            XX
XX  XXXXXXX  XXXXXX  XXXXXXX  XX
XX                            XX
XX                            XX
XX                            XX
XXP                           XX
XXXXXXXXXXXXXXXXXXXXXXXXXXXXXXXX